# Copyright (c) Microsoft Corporation.
# Licensed under the MIT license.
subscriptionName="<subscriptionID>" # subscriptionID
resourceGroupName="<ResourceGroupName>"
resourceGroupLocaltion="<Location>"
# CONTAINER REGISTERY DETAILS
acrRegistryName="<ACR name>"
# STORAGE ACCOUNT FILE SHARE DETAILS
aksStorageAccountname="<StorageAccountname>"
aksFileSharename="<FileSharename>"
aksStorageAccountSKU="<StorageAccountSKU>"  
# AZURE KEY VAULT DETAILS
akvName="<keyvault-name>"
# AZURE CLUSTER DETAILS
clusterName="<cluster-name>"
# CREATING AKS CLUSTER
workerNodeCount=<NodeCount>
kubernetesVersion="1.21.9"
networkPlugin="azure"
loadBalancerSKU="<loadBalancerSKU>"
nodeVMSize="<nodeVMSize>"
winNodePoolName="<winNodePoolName>"
winNodeVMSize="<winNodeVMSize>"
winWorkerNodeCount=<winWorkerNodeCount>
enableAutoScaler=True
nodeMinCount=<nodeMinCount>
nodeMaxCount=<nodeMaxCount>
enableMonitoring=True
# CREATING MYSQL SERVER 
mysqlServerName="<mysqlServerName>"
mysqlServerAdminUser="<mysqlServerAdminUser>"
mysqlServerAdminUserPassword="<mysqlServerAdminUserPassword>"
mysqlDatabaseName="<mysqlDatabaseName>"
mysqlskuname="<mysqlskuname>"
mysqlstoragesize= "<mysqlstoragesize>"